1,1,1,1,1,1,1,1,1,1,1,1,1,1,1
1,0,3,0,0,0,0,0,0,0,0,0,0,0,1
1,0,0,0,0,0,0,0,0,0,0,0,0,0,1
1,0,0,0,0,0,0,0,0,0,0,0,0,0,1
1,0,0,0,0,13,0,0,0,0,0,0,0,0,1
1,0,0,0,22,22,22,22,22,0,0,0,13,0,1
1,0,0,12,22,22,22,22,22,1,0,0,0,0,1
1,0,0,0,22,22,15,22,22,22,22,4,4,4,1
1,0,0,0,22,22,22,22,22,0,0,4,4,0,1
1,0,0,0,22,22,22,22,22,4,4,4,4,0,1
1,0,0,0,14,0,0,0,4,4,0,0,0,0,1
1,0,0,0,0,0,0,0,4,0,0,0,0,0,1
1,0,0,0,4,4,4,4,4,0,0,0,5,0,1
1,0,0,0,4,0,0,0,0,0,0,0,0,0,1
1,1,1,1,1,1,1,1,1,1,1,1,1,1,1
