1,1,1,1,1,1,1,1,1,1,1,1,1,1,1
1,0,0,0,0,0,4,4,0,0,0,0,0,0,1
1,0,0,0,0,14,4,4,0,0,0,0,0,0,1
1,0,0,0,0,0,4,4,0,0,0,0,0,0,1
1,4,4,4,4,4,4,4,0,15,0,0,0,0,1
1,0,0,0,0,4,4,4,0,0,0,0,0,0,1
1,3,0,0,13,4,4,4,0,0,0,0,0,0,1
1,0,0,0,0,4,4,4,0,0,0,0,0,0,1
1,0,0,0,0,4,4,4,0,0,0,0,0,0,1
1,4,4,4,4,4,4,4,0,0,0,0,0,0,1
1,4,4,4,4,4,4,4,0,0,0,0,0,0,1
1,0,0,0,0,0,4,4,0,0,0,0,0,0,1
1,5,0,0,0,0,4,4,0,0,0,0,0,0,1
1,0,0,0,0,0,4,4,0,0,0,0,0,0,1
1,1,1,1,1,1,1,1,1,1,1,1,1,1,1
