1,1,1,1,1,1,24,24,1,1,1,1,1,1
1,0,0,0,0,0,21,21,0,0,0,0,0,1
1,0,0,0,0,13,21,21,0,0,0,0,0,1
1,0,0,0,0,0,24,24,0,0,0,13,0,1
24,22,22,22,22,24,21,21,24,22,22,22,24,24
24,22,22,22,22,24,21,21,24,22,22,22,24,24
1,0,0,0,0,0,21,21,0,0,0,0,0,1
1,0,0,13,0,0,21,21,0,0,0,0,0,1
1,0,0,0,0,0,21,21,0,0,0,0,0,1
1,0,0,0,0,0,21,21,0,0,0,0,0,1
1,0,0,0,0,0,21,21,0,0,0,0,0,1
1,0,0,0,0,0,21,21,4,4,4,4,4,1
1,0,3,0,0,0,21,21,0,0,0,0,0,1
1,0,0,0,0,0,24,24,0,0,0,5,0,1
1,1,1,1,1,1,24,24,1,1,1,1,1,1
