1,1,1,1,1,1,1,1,1
1,0,0,11,0,0,0,1,1
1,0,0,11,12,0,0,11,1
1,0,0,3,0,11,0,1,1
1,1,1,1,1,1,1,1,1
