1,1,1,1,1,1,1,1,1,1,1,1,1,1,1
1,3,0,0,4,0,0,0,0,0,0,4,0,5,1
1,0,13,0,4,0,0,0,0,15,0,4,0,0,1
1,0,0,0,4,0,0,0,0,0,0,4,4,4,1
1,4,4,4,4,4,4,4,4,0,0,4,0,12,1
1,4,4,4,0,0,0,0,4,0,0,4,0,0,1
1,0,0,4,0,0,1,0,4,4,4,4,0,0,1
1,0,13,4,0,0,4,0,4,4,4,0,0,0,1
1,0,0,4,0,0,4,4,4,4,4,0,0,0,1
1,4,4,4,0,0,4,0,4,0,0,0,0,0,1
1,4,4,4,0,14,4,4,4,0,0,0,0,0,1
1,0,0,4,4,4,4,4,4,4,4,4,4,0,1
1,0,0,0,4,4,4,15,4,4,4,4,4,0,1
1,0,0,0,4,0,0,0,0,4,4,4,4,4,1
1,0,0,0,0,0,0,0,0,0,0,0,0,0,1
1,1,1,1,1,1,1,1,1,1,1,1,1,1,1
