1,1,1,1,1,1,1,1,1,24,24,1,1
1,0,0,0,0,0,13,0,0,21,21,0,1
1,0,0,11,12,0,0,0,13,21,21,0,1
1,0,0,3,0,0,0,0,0,21,21,0,1
1,0,0,0,0,0,4,0,0,21,21,0,1
1,0,0,0,0,11,11,0,0,21,21,0,1
1,0,0,0,0,0,0,0,4,21,21,5,1
1,0,0,0,0,0,0,0,0,23,23,0,1
1,1,1,1,1,1,1,1,1,24,24,1,1
